{
  "metadata": {
    "name": "startlev15",    "levelNumber": 15,    "decisionType": 3,    "endType": 2,    "targetType": 7,    "maxMilk": 850,    "generator": false,    "nextLevel": 19,    "startPosition": {
      "x": 23,      "y": 40
    }
  },  "aiSettings": {
    "gatherPoint": {
      "x": 28,      "y": 15
    },    "pasture": {
      "x": 45,      "y": 9
    }
  },  "specialLocations": {
    "healingShrine": {
      "x": 5,      "y": 20
    }
  },  "terrain": {
    "width": 69,    "height": 66,    "tiles": [
      [
17,17,17,17,17,17,17,17,17,17,17,17,17,17,17,15,17,17,17,17,17,17,17,17,17,17,17,17,11,17,17,17,17,17,17,17,17,17,17,17,17,17,17,17,17,17,17,17,17,17,17,17,17,11,17,8,8,8,8,8,8,8,8,8,8,8,8,8,8
      ],      [
8,8,8,8,8,8,8,10,16,16,16,14,8,8,8,15,8,8,8,8,8,8,8,8,10,16,16,16,18,8,8,8,8,8,8,8,8,10,16,16,16,16,14,8,8,8,8,8,8,8,8,8,10,18,113,118,8,8,8,8,114,116,118,8,8,8,8,8,8
      ],      [
16,16,16,14,8,10,16,18,117,115,116,19,16,16,14,19,16,16,16,16,14,8,8,10,18,10,16,16,16,16,16,16,16,16,16,16,16,18,113,115,116,115,19,16,16,16,16,16,16,16,16,16,18,8,116,8,113,116,115,8,8,117,8,113,8,8,8,8,8
      ],      [
35,35,35,19,16,18,35,35,35,113,118,113,116,118,19,16,16,16,16,14,19,16,16,18,10,18,113,114,115,115,113,118,117,118,118,114,113,118,114,8,118,113,117,116,113,117,117,114,118,117,118,113,8,114,8,115,8,8,8,8,8,8,8,8,8,8,8,8,8
      ],      [
8,113,35,35,35,35,35,113,35,35,35,35,35,35,35,35,8,8,8,19,14,8,8,10,18,114,115,117,118,116,8,114,113,8,8,113,116,115,113,114,8,8,116,115,113,8,8,116,115,8,113,8,118,117,115,8,8,8,8,8,8,8,8,8,8,8,8,8,8
      ],      [
8,8,116,114,8,8,118,114,117,8,118,8,116,8,113,35,35,35,35,116,19,16,16,18,113,115,114,8,115,8,116,117,8,116,8,118,117,8,116,8,116,113,115,8,118,114,116,117,113,8,115,119,8,114,8,8,8,8,8,8,8,8,8,8,8,8,8,8,8
      ],      [
17,8,113,115,113,8,113,8,114,116,8,117,113,115,8,116,115,8,35,35,35,35,35,116,117,114,8,117,118,117,114,113,113,8,113,116,115,117,8,119,115,8,116,8,8,8,8,8,8,8,8,8,8,8,8,8,8,8,8,8,8,8,8,8,8,8,8,8,8
      ],      [
8,13,13,13,21,116,115,114,8,8,119,8,8,8,8,8,8,8,116,8,118,116,35,35,113,8,116,113,119,114,117,8,115,116,8,113,117,116,8,113,8,118,8,8,8,8,8,8,8,8,8,8,8,8,8,8,8,8,8,8,8,195,8,8,8,8,8,8,8
      ],      [
8,13,13,21,9,13,13,13,21,117,114,115,114,8,113,116,115,113,8,8,113,117,114,35,35,116,116,8,117,118,116,8,8,8,8,8,115,8,8,266,8,8,8,8,8,8,8,8,8,8,8,8,8,35,35,35,35,35,35,35,35,35,8,8,8,8,8,8,8
      ],      [
8,8,8,11,8,8,10,16,18,113,8,116,8,114,117,8,113,116,117,8,8,8,8,8,35,35,35,116,114,113,8,116,118,115,8,8,8,8,8,266,8,8,8,8,8,8,8,8,8,8,8,119,8,35,8,8,8,8,8,8,8,8,8,8,8,8,8,8,8
      ],      [
8,8,8,11,10,16,18,114,114,8,113,115,118,117,8,116,8,115,118,116,113,117,8,115,116,113,35,35,8,116,115,118,8,8,8,8,8,8,266,266,8,8,8,8,8,8,116,8,8,8,175,8,8,35,8,8,8,8,8,8,8,8,8,8,8,8,8,8,8
      ],      [
8,16,16,18,11,113,115,117,118,116,8,114,116,8,115,8,8,113,118,8,114,115,8,8,8,115,116,35,35,35,35,35,35,8,8,8,35,35,35,35,35,35,8,8,8,175,35,35,35,35,35,35,35,35,8,8,8,8,175,117,8,8,8,8,8,8,8,8,8
      ],      [
8,8,10,16,18,8,8,8,114,119,115,8,117,118,8,8,116,8,114,117,8,113,8,117,118,8,8,35,8,8,8,8,35,35,35,35,35,8,266,266,8,35,35,35,35,35,35,8,8,8,8,8,8,35,35,35,35,35,35,8,8,8,8,8,8,8,8,8,8
      ],      [
17,16,18,115,114,116,118,8,115,8,116,8,8,115,8,113,118,117,8,118,8,8,8,8,8,8,35,35,8,8,8,8,8,8,8,8,8,8,8,266,8,8,8,8,8,8,8,8,8,8,8,8,8,35,8,8,8,8,8,8,8,8,8,8,8,8,8,8,8
      ],      [
8,118,116,8,8,113,115,8,8,117,8,8,117,118,113,117,8,8,8,8,8,8,8,8,8,35,35,8,8,8,8,8,8,8,8,8,8,8,8,8,8,8,8,8,8,8,8,8,8,8,8,8,195,35,8,8,8,8,8,8,8,8,8,8,8,8,8,8,8
      ],      [
8,8,8,8,115,116,8,8,118,8,8,114,116,8,8,8,8,8,8,8,8,35,35,35,35,35,8,8,8,8,8,8,8,116,8,8,8,8,8,8,8,8,8,8,8,8,8,8,22,22,22,8,35,35,118,8,8,8,8,8,8,8,8,8,8,8,8,8,8
      ],      [
8,8,8,8,8,8,8,8,8,113,8,8,8,8,8,8,8,8,8,8,35,35,8,8,8,8,8,8,8,8,8,8,8,8,8,8,8,8,8,8,8,8,8,8,8,8,8,22,22,22,22,22,8,8,8,8,8,8,8,8,8,8,8,8,8,8,8,8,8
      ],      [
8,8,8,8,8,8,8,8,8,8,8,8,8,8,8,8,8,8,8,35,35,8,8,8,8,8,8,8,8,8,8,8,8,8,8,8,8,8,8,8,8,8,8,8,8,8,8,22,22,22,22,22,8,8,8,8,8,8,8,8,8,8,8,8,8,8,8,8,8
      ],      [
8,8,8,8,8,8,8,8,8,8,8,8,8,8,8,8,8,8,35,35,8,8,8,8,8,8,8,8,8,8,8,8,8,8,8,8,8,8,8,8,8,8,8,8,8,8,8,8,22,22,22,8,8,8,8,8,8,8,8,8,8,8,8,8,8,8,8,8,8
      ],      [
8,8,8,8,68,61,68,8,8,8,8,8,8,8,8,8,8,35,35,8,8,8,8,8,8,8,8,8,8,8,8,8,8,8,8,8,8,8,8,8,8,8,8,8,8,8,8,8,8,8,8,8,8,8,8,8,8,8,8,8,8,8,8,8,8,8,8,8,8
      ],      [
8,8,8,8,256,256,256,8,8,8,8,8,8,8,8,8,35,35,8,8,8,8,8,8,8,8,8,8,8,8,8,8,8,8,8,8,8,8,8,8,8,8,8,8,8,8,8,8,8,8,8,8,8,8,8,8,8,8,8,8,8,8,8,8,8,8,8,8,8
      ],      [
8,8,8,8,8,8,8,8,8,8,8,8,8,8,8,8,35,8,8,8,8,8,8,8,8,8,8,8,8,8,8,8,8,8,8,8,8,8,8,8,8,8,8,8,8,8,8,8,8,8,8,8,8,8,8,8,8,8,8,8,8,8,8,8,8,8,8,8,8
      ],      [
8,8,8,8,8,8,8,8,8,8,8,8,8,8,8,8,35,8,8,8,8,8,8,8,8,8,8,8,8,8,8,8,8,8,8,8,8,8,8,8,8,8,8,8,8,8,8,8,8,8,8,8,8,8,8,8,8,8,8,8,66,8,8,8,8,8,8,8,8
      ],      [
8,8,8,8,8,8,8,8,8,8,8,8,8,8,8,8,35,116,8,8,8,8,8,8,8,8,8,8,8,8,8,8,8,8,8,8,8,8,8,8,8,8,8,8,8,8,8,8,8,8,8,8,8,8,8,8,8,8,8,8,8,67,8,8,8,8,8,8,8
      ],      [
8,8,8,8,8,8,8,8,8,8,8,8,8,8,8,8,47,8,8,8,8,8,8,8,8,8,8,8,8,8,8,8,8,8,8,8,8,8,8,8,8,8,8,8,8,8,8,8,8,8,8,8,8,8,8,8,8,8,8,57,8,8,8,8,8,8,8,8,8
      ],      [
8,8,8,8,8,8,8,8,8,8,8,8,8,8,8,8,52,8,8,8,8,8,8,8,8,8,8,8,8,8,8,8,8,8,8,8,8,8,8,8,8,8,8,8,8,8,8,8,8,8,8,8,8,8,8,8,8,8,8,8,56,8,8,8,8,8,8,8,8
      ],      [
8,8,8,8,8,8,8,8,8,8,8,8,8,8,8,8,47,8,8,8,8,8,8,8,8,8,8,8,8,8,8,8,8,8,8,8,8,8,8,8,8,8,8,8,8,8,8,8,8,8,8,8,8,8,8,8,8,8,8,8,8,8,8,8,8,8,8,8,8
      ],      [
8,8,8,8,8,8,8,8,8,8,8,8,8,8,8,117,35,119,8,8,8,8,8,8,8,8,8,8,8,8,8,8,8,8,8,8,8,8,116,8,8,8,8,8,8,8,8,8,8,8,8,8,8,8,8,8,8,8,8,67,8,8,8,8,8,8,8,8,8
      ],      [
8,8,8,8,8,8,8,8,8,8,8,8,8,8,8,8,35,8,8,8,8,8,8,8,8,8,8,8,8,8,8,8,8,8,8,8,8,8,8,8,113,8,8,8,8,8,8,8,8,8,8,8,8,8,8,8,8,22,22,8,56,8,8,8,8,8,8,8,8
      ],      [
8,8,8,8,8,8,8,8,8,8,8,8,8,8,8,8,35,8,8,8,8,22,22,22,8,8,8,8,8,8,8,8,8,8,8,8,8,8,8,118,8,8,8,8,8,8,8,8,115,8,8,8,8,8,8,8,8,22,22,22,8,8,8,8,8,8,8,8,8
      ],      [
8,8,8,8,8,8,8,8,8,8,8,8,8,8,8,8,35,8,8,8,22,22,22,22,8,8,8,8,8,8,8,8,8,8,8,8,8,8,8,8,8,117,114,8,8,8,8,8,8,8,8,8,8,8,8,119,22,22,22,8,8,8,8,8,8,8,8,8,8
      ],      [
8,8,8,8,8,8,8,8,8,8,8,8,8,8,8,8,35,8,8,8,22,22,22,8,8,8,8,8,8,8,8,8,8,8,8,8,8,8,8,8,8,8,8,8,8,8,8,8,8,8,8,8,8,8,22,22,22,22,22,119,8,8,8,8,8,8,8,8,8
      ],      [
8,8,8,8,8,8,8,116,8,8,8,8,8,8,8,8,35,35,8,8,8,8,8,8,8,8,8,8,8,8,8,8,8,8,8,8,8,8,8,8,8,8,8,8,8,8,8,8,8,8,8,8,8,8,8,8,22,22,22,22,8,8,8,8,8,8,8,8,8
      ],      [
8,8,8,8,8,8,8,8,8,8,8,8,8,8,8,8,8,35,8,8,8,8,8,8,8,8,8,8,8,8,8,8,8,8,8,8,8,8,8,8,8,8,8,8,8,8,8,8,8,8,8,8,8,8,8,22,22,22,22,22,8,8,8,8,8,8,8,8,8
      ],      [
8,8,8,8,8,8,8,8,8,8,8,8,8,117,8,8,8,35,8,8,8,8,8,8,8,8,8,8,8,8,8,8,8,8,8,8,8,8,8,8,8,8,8,8,8,8,8,8,8,8,8,8,8,8,67,8,22,22,22,22,22,8,8,8,8,8,8,8,8
      ],      [
8,8,8,8,8,8,8,8,8,8,8,8,8,8,8,8,8,35,8,8,8,8,8,8,8,8,8,8,8,8,8,8,8,8,8,8,8,8,8,8,8,8,8,8,8,8,8,118,8,8,8,8,8,8,8,8,119,22,22,22,8,8,8,8,8,8,8,8,8
      ],      [
8,8,8,116,8,8,8,8,8,8,8,8,8,8,8,8,8,35,35,8,8,8,8,8,8,8,8,8,8,8,8,8,8,8,8,8,8,8,8,8,8,8,8,8,8,8,117,8,8,8,8,8,8,57,8,8,22,22,22,8,8,8,8,8,8,8,8,8,8
      ],      [
35,35,35,35,35,35,8,8,8,8,8,8,8,8,8,8,8,8,35,35,8,8,8,8,8,8,8,8,8,8,8,8,8,8,8,8,8,8,22,22,8,8,8,8,8,8,8,8,8,8,8,8,8,8,8,8,8,8,8,8,8,8,8,8,8,8,8,8,8
      ],      [
8,58,8,8,8,35,35,35,35,35,35,35,8,8,8,8,8,8,8,35,35,8,8,8,8,8,8,8,8,8,8,8,8,8,8,8,8,22,22,22,22,8,8,8,8,8,8,8,8,8,8,8,8,8,8,8,8,119,8,8,8,8,8,8,8,8,8,8,8
      ],      [
8,8,8,8,8,8,8,8,8,8,8,35,35,35,35,8,8,8,8,8,35,35,8,8,8,8,8,8,8,8,8,8,8,8,8,8,8,22,8,22,22,22,8,8,8,8,8,8,8,8,8,8,8,8,8,8,8,8,8,8,8,8,35,35,35,35,8,8,8
      ],      [
8,8,8,8,8,8,8,8,8,8,8,8,8,8,35,8,8,8,8,8,8,35,35,8,8,8,8,8,8,8,8,8,8,8,8,8,8,8,8,8,8,8,8,8,8,8,8,8,8,8,8,8,8,8,8,8,8,8,8,35,35,35,35,8,58,8,8,8,8
      ],      [
8,8,8,8,8,8,8,8,8,8,8,8,8,8,8,8,8,8,8,8,8,61,8,8,8,8,8,8,8,8,8,8,8,8,8,8,8,8,8,266,266,266,266,266,266,266,266,266,266,266,266,266,266,266,266,266,266,266,266,266,266,266,266,266,266,266,266,266,266
      ],      [
8,8,8,8,8,8,8,8,8,8,8,8,8,8,8,8,8,8,35,35,35,35,35,8,8,8,8,8,8,8,8,8,8,8,8,8,8,119,8,8,8,8,57,266,266,266,266,266,266,8,8,8,266,266,266,266,266,8,8,8,8,8,8,8,8,8,8,8,8
      ],      [
8,56,8,8,8,8,8,8,8,8,8,8,8,8,8,8,8,8,117,8,8,8,35,8,8,8,8,8,8,8,8,8,8,8,8,8,8,8,8,8,119,8,35,35,35,35,8,8,266,8,8,8,266,8,8,8,8,8,8,8,8,8,8,8,8,8,8,8,8
      ],      [
13,21,57,8,8,8,8,8,8,8,8,8,8,8,8,8,8,8,8,8,119,8,35,8,8,8,8,8,8,8,8,8,8,8,8,8,8,113,8,8,8,8,8,8,8,35,8,8,266,8,8,165,266,8,8,8,8,8,8,8,8,8,8,8,8,8,8,8,266
      ],      [
8,9,13,21,56,57,8,8,8,8,8,8,8,8,8,8,8,8,8,8,8,8,35,8,8,8,8,8,8,8,8,8,8,8,8,8,8,8,8,8,8,8,8,8,8,35,35,35,266,266,266,266,266,8,8,8,8,8,8,8,8,8,8,8,8,8,8,8,8
      ],      [
8,57,56,9,13,13,13,13,21,57,8,8,8,8,8,8,8,8,8,8,8,8,35,8,8,8,8,8,8,8,8,8,8,8,8,8,8,8,8,8,8,8,8,8,145,35,22,22,22,119,22,22,8,8,266,266,8,8,8,8,8,8,8,8,8,8,8,8,8
      ],      [
8,10,16,16,16,16,14,57,9,13,13,21,57,8,8,8,8,8,8,8,8,8,35,35,8,8,8,8,8,8,8,8,8,8,8,8,8,8,8,8,8,8,35,35,35,35,22,22,22,8,22,22,22,8,266,118,8,8,8,8,8,8,8,8,8,8,8,8,8
      ],      [
16,18,114,57,57,56,19,16,14,57,8,9,21,56,8,8,8,8,8,8,8,8,8,35,35,8,8,8,22,50,51,50,22,8,8,8,8,35,35,35,35,35,35,8,8,8,22,22,22,8,22,22,22,116,266,8,8,8,8,8,8,8,8,8,8,8,8,8,8
      ],      [
8,8,8,113,116,8,114,56,19,16,16,16,18,57,8,8,8,8,8,8,8,8,8,8,35,35,35,35,22,50,50,50,22,35,35,35,35,35,8,8,8,117,8,8,8,8,64,8,8,8,8,266,266,266,266,8,8,8,8,8,8,8,8,8,8,8,8,8,8
      ],      [
8,115,8,8,8,8,8,8,8,57,8,8,56,8,8,8,8,8,8,8,8,8,8,8,8,8,8,8,22,50,49,50,22,8,8,8,8,35,266,266,8,8,8,8,8,8,266,266,266,266,266,266,8,8,8,8,8,8,8,8,57,8,8,8,8,8,8,8,8
      ],      [
8,8,8,8,8,8,8,8,8,8,8,8,8,8,8,8,8,8,8,8,8,8,8,8,8,8,8,8,8,8,8,8,8,8,8,8,8,35,35,266,266,8,8,8,266,266,266,8,8,8,8,8,8,8,8,8,8,8,8,8,8,56,8,8,8,8,8,8,8
      ],      [
8,8,8,8,8,8,8,8,8,8,8,8,8,118,8,8,8,8,8,8,8,8,8,8,8,8,8,8,8,8,8,8,8,8,8,8,8,8,35,35,266,266,266,266,266,8,8,8,8,8,8,8,8,8,8,8,8,8,8,8,8,8,8,8,8,8,8,8,8
      ],      [
8,8,8,8,8,8,8,8,8,8,8,8,8,8,8,8,8,8,8,8,8,8,8,8,8,8,8,8,8,8,8,8,8,8,8,8,8,8,8,35,35,35,35,8,8,8,8,8,8,8,8,8,8,8,8,8,8,8,67,119,8,67,8,8,8,8,8,8,8
      ],      [
8,8,8,8,8,8,8,8,8,8,8,8,8,8,8,8,8,8,8,8,8,8,8,8,8,8,8,8,8,8,8,8,8,8,8,8,8,8,8,8,8,8,35,35,8,8,8,8,8,8,8,8,8,8,8,8,8,8,8,57,113,8,8,8,8,8,8,8,8
      ],      [
8,8,118,8,8,8,8,8,8,8,8,8,8,8,8,8,8,8,8,8,8,8,8,8,8,8,8,8,8,8,8,8,8,8,8,8,8,8,8,8,8,8,8,35,8,8,8,8,8,8,8,8,8,8,8,8,8,56,60,8,56,8,8,8,8,8,8,8,8
      ],      [
8,114,8,113,8,8,8,8,8,8,8,8,8,8,8,8,8,8,8,8,8,119,8,8,8,8,8,8,8,8,22,8,8,8,8,8,8,8,8,8,8,8,8,35,119,8,8,8,8,8,8,8,8,8,8,8,8,8,8,67,8,8,8,8,8,8,8,8,8
      ],      [
8,116,8,8,115,8,8,8,8,8,8,8,8,8,8,8,8,8,8,8,8,8,8,8,8,8,8,8,8,22,22,22,8,8,8,8,8,8,8,8,8,8,8,35,35,8,8,8,8,8,8,8,8,8,8,8,114,8,8,8,8,8,8,8,8,8,8,8,8
      ],      [
8,8,117,8,8,8,8,119,8,8,8,8,8,8,8,8,8,8,8,8,8,119,8,8,8,8,8,8,22,22,22,22,22,8,8,8,8,8,8,8,8,8,8,8,35,8,8,8,8,8,8,116,8,8,8,8,8,8,8,8,8,8,8,8,8,8,8,8,8
      ],      [
8,113,8,8,8,116,8,8,8,8,8,8,8,8,8,8,8,8,8,8,8,8,8,8,8,8,8,8,8,22,22,22,22,8,8,8,8,8,8,8,8,8,8,8,35,35,35,8,8,8,115,8,118,8,8,8,8,8,8,8,8,8,8,8,8,8,8,8,8
      ],      [
8,116,8,114,8,8,8,117,8,8,8,8,8,8,8,8,8,8,8,8,8,8,8,8,8,8,8,8,22,22,22,22,8,8,8,8,8,8,8,8,8,8,8,8,8,8,35,8,8,8,8,8,8,8,8,8,8,8,8,8,8,8,8,8,8,8,8,8,8
      ],      [
8,8,115,8,118,8,8,8,8,8,8,8,8,8,8,8,8,8,8,8,8,8,8,8,8,8,8,8,22,22,8,22,22,22,8,8,8,8,8,8,8,8,8,8,8,8,35,35,8,8,8,8,8,8,8,8,8,8,8,8,8,8,8,35,35,8,8,8,8
      ],      [
8,8,8,8,8,116,8,8,113,8,8,8,8,8,8,8,8,8,8,8,8,116,8,8,8,8,8,8,8,22,8,22,22,8,8,8,8,8,8,8,8,8,8,8,8,8,8,35,35,35,35,35,35,8,8,8,8,35,35,35,35,35,35,35,58,8,8,8,8
      ],      [
8,113,8,117,8,8,8,118,114,8,8,115,8,8,8,8,8,8,8,8,8,8,117,8,8,8,8,8,8,8,8,22,8,8,8,8,8,8,8,8,8,8,8,8,8,8,8,8,8,8,8,8,35,35,35,35,35,35,8,8,8,8,8,8,8,8,8,8,8
      ],      [
8,8,8,8,116,115,8,8,117,113,8,8,117,8,8,8,8,8,8,8,118,8,8,8,8,8,8,8,8,8,8,8,8,8,8,8,8,8,8,8,8,8,8,8,8,8,8,8,8,8,8,8,8,8,8,8,8,8,8,8,8,8,8,8,8,8,8,8,8
      ],      [
8,8,8,8,8,8,8,8,8,8,8,8,8,8,8,8,8,8,8,8,8,8,8,8,8,8,8,8,8,8,8,8,8,8,8,8,8,8,8,8,8,8,8,8,8,8,8,8,8,8,8,8,8,8,8,8,8,8,8,8,8,8,8,8,8,8,8,8,8
      ]
    ]
  },  "buildings": [
    {
      "type": "BARRACKS",      "owner": "ENEMY",      "position": {
"x": 61,"y": 7
      }
    },    {
      "type": "BARN",      "owner": "ENEMY",      "position": {
"x": 50,"y": 10
      }
    },    {
      "type": "BARN",      "owner": "ENEMY",      "position": {
"x": 45,"y": 11
      }
    },    {
      "type": "BARN",      "owner": "ENEMY",      "position": {
"x": 58,"y": 11
      }
    },    {
      "type": "BARRACKS",      "owner": "ENEMY",      "position": {
"x": 52,"y": 14
      }
    }, {
      "type": "BARN",      "owner": "PLAYER",      "position": {
"x": 51,"y": 44
      }
    },    {
      "type": "MAIN",      "owner": "PLAYER",      "position": {
"x": 44,"y": 46
      }
    },    {
      "type": "BARN",      "owner": "PLAYER",      "position": {
"x": 45,"y": 50
      }
    }
  ],  "units": [
     {
      "type": "AXEMAN",      "owner": "ENEMY",      "position": {
"x": 49,"y": 40
      }
    }, {
      "type": "COMMANDER",      "owner": "PLAYER",      "position": {
"x": 28,"y": 46
      }
    }
  ]
}
